NO 1.png
EA 1.png
WE 1.png
SO 1.png

F 0,0,0
C 0,0,0


1D11111111
10000001
1D00000N1
111111111