EA 1.png
SO 1.png
NO 1.png
WE 1.png

F 1,1,1
C 1,1,1
      1  
1N11110111
10000000001
10000000001
10000000001
1000000001
10000000001
1111111111