NO ./assets/textures/hitler.png
EA ./assets/textures/red_wall.png
SO ./assets/textures/ss.png
WE ./assets/textures/brick.png
C 0,0,255
F 255, 0,0


11111111111
10000000011
10000000001
10000000001
100E0001011
10000000001
10000000001
10000000001
11111111111