
1111111
100S0O1
1110111
1000001
1110111
1110111
1111111
