111111111111111111111111111111111111111111111111111111111111111111111111111111111111111111111111111111111
1D1O1O100000000000000000000000000000000000000000000000000000000000000000000000000000000000000000000000011
100N00D00000000000000000000000000000000000000000000000000000000000000000000000000000000000000000000000011
100000100000000000000000000000000000000000000000000000000000000000000000000000000000000000000000000000011
110000100000000000000000000000000000000000000000000000000000000000000000000000000000000000001D10000000011
1O0000D0000000000000000000000000000000000000000000000000000000000000000000000000000000000000000000000011
11D1D110000000000000000000001D100000000000000000000000000000000000000000000000000000000000000000000000011
1000000000000000000000000000D0000000000000000000000000000000000000000000000000000000000000000000000000011
100000000000000000000000000010000000000000000000000000000000000000000000000000000000000000000000000000O11
1000000000000000000000000000D0000000000000000000000000000000000000000000000000000000000000000000000000111
100000000000000000000000000010000000000000000000000000000000000000000000000000000000000000000000000000D11
100111D1D100000000000000000000000000000000000000000000000000000000000000000000000000000000000000000000111
100000000000000000000000000000000000000000000000000000000000000000000000000000000000000000000000000000011
100000000000000000000000000000000000000000000000000000000000000000000000000000000000000000000000000000011
1000000000000000000000000000000000000000000000000000000000e0000000000000000000000000000000000000000000011
100000000000000000000000000000000000000000000000000000000000000000000000000000000000000000000000000000011
100000000000000e00000000000000000000000000000000000000000000000000000000000000000000000000000000000000011
100000000000000000000000000000000000000000000000000000000000000000000000000000000000000000000000000000011
100000000000000000000000000000000000000000000000000000000000000000000000000000000000000000000000000000011
100000000000000000000000000000000000000000000000000000000000000000000000000000000000000000000000000000011
100000000000000000000000000000000000000000000000000000000000000000000000000000000000000000000000000000011
100000000000000000000000000000000000000000000000000000000000000000000000000000000000000000000000000000011
10e000000000000000000000000000000000000000000000000000000000000000000000000000000000000000000000000000e11
111111111111111111111111111111111111111111111111111111111111111111111111111111111111111111111111111111111
