1111111111111111111111111111111111111111111111111111111111111
1000000000001D10000000000000000000001000000000000000000000001
1000000000000000000000000000000000000000000000000000000000001
1100000000000000000000000000000100000000000000000000000000001
1D00000000000000000101000000000000000000000000000000000000e01
1100000000000000000001000000000000001000000000000000000000001
1000000000000000000001110000000000000000000000000000000000001
100000000000000000000D001000000000000000000000000000000000001
1O00000000000000000001111000000000000000000000000000000000001
1000000000000000000000000000000000000000000000000000000000001
1000000000000000000000000000000000000000000000000000000000001
1000000000000000000000000000000000000000000000000000000000001
1O00000000000000000000000000000000000000000000000000000000001
1000000000000000000000000000000000000000000000000000000000001
1000000000000000000000000000000000000000000000000000000000001
1000000000000000000000000000000000000000000000000000000000001
1000000000000000000000000000000000000000000000000000000000001
1100000000000000000000000000000000000000000000000000000000001
1O001O0100000000000000000000000000000000000000000000000000001
1111111111111111111111111111111111111111111111111111111111111
