1111111
1000001
1111111
1000001
1110111
1110111
1111111