111111
1010101
1000N11
1101001
111111