NO ../assets/textures/hitler.png
EA ../assets/textures/red_wall.png
SO ../assets/textures/ss.png
WE ../assets/textures/brick.png
C 205,111,221
F 0,1,2


1111111111111111111111111111
10001100000000000000000000011
11100011D1000000101110100011
10001000000100000010010010011111111111111111111111111111111111111111111111111111
10010100S000000001000000000000000000000e0000000000000000000000000000000000000001
100001000000000000000000000000000000000e0000000000010000000000000000000000000001
100101000000000000000000000100000000000e0000000000000000000000000000000000000001
10000110000000000000000000O11111111111111111111111111111111111111111111111111111
10000100000000000000000000O1
1000000000000000000000100111
10000100000100000000010001
10000010001 1000000000000111
1111111111  1111111111111111
