NO ../assets/textures/hitler.png
EA ../assets/textures/red_wall.png
SO ../assets/textures/ss.png
WE ../assets/textures/brick.png
C 205,111,221
F 0,1,2

111111
100001
100N01
100001
111111
