NO ../assets/textures/hitler.png
EA ../assets/textures/red_wall.png
SO ../assets/textures/ss.png
WE ../assets/textures/brick.png
C 205,111,221
F 0,1,2


1111111111111111111111111111111111111111111111111111111111111
100000000000101N000000000000000000001000000000000000000000001
1000000000000000000000000000000000000000000000000000000000001
1000000000000000000000000000000100000000000000000000000000001
1000000000000000000000000000000000000000000000000000000000001
1000000000000000000000000000000000001000000000000000000000001
1000000000000000000000000000000000000000000000000000000000001
1100000000000000000000000000000000000000000000000000000000001
1000000000000000000001111000000000000000000000000000000000001
1100000000000000000000000000000000000000000000000000000000001
1000000000000000000000000000000000000000000000000000000000001
1100000000000000000000000000000000000000000000000000000000001
1000000000000000000000000000000000000000000000000000000000001
1100000000000000000000000000000000000000000000000000000000001
1000000000000000000000000000000000000000000000000000000000001
1000000000000000000000000000000000000000000000000000000000001
1000000000000000000000000000000000000000000000000000000000001
1100000000000000000000000000000000000000000000000000000000001
1000100100000000000000000000000000000000000000000000000000001
1111111111111111111111111111111111111111111111111111111111111
