NO ../assets/textures/zalij1 .png
EA ../assets/textures/red_wall.png
SO ../assets/textures/ss.png
WE ../assets/textures/brick.png
C 205,111,221
F 0,1,2


1111111
100S001
111DD111
1000001
1110111
1110111
1111111