NO ../assets/textures/hitler.png
EA ../assets/textures/red_wall.png
SO ../assets/textures/ss.png
WE ../assets/textures/brick.png
C 205,111,221
F 0,1,2


1111111111111111111111111111
10001100000000000000000000011
11100011D1000000101110100011
10001000000100000O10010010011111111111111111111111111111111111111111111111111111
10010100S00000000100000000000000000000000000000000000000000000000000000000000001
10000100000000000000000000000000000000000000000000010000000000000000000000000001
10010100000000000000000000010000000000000000000000000000000000000000000000000001
1000011000O0000000000O0000011111111111111111111111111111111111111111111111111111
1000010e00000000000000000001
1000000000000000000000100111
10000100000100000000010001
10000010001 1000000000000111
1111111111  1111111111111111