NO ./assets/textures/hitler.png
EA ./assets/textures/red_wall.png
SO ./assets/textures/ss.png
WE ./assets/textures/brick.png
C 0,0,255
F 255, 0,0

1111111
1000001
1000001
1000001
111N111
1110111
1111111